##########
#........#
#.###.##.#
#.#M...#.#
#.###.##.#
#........#
#..####..#
#..#M.#..#
#........#
##########
